#-------#
.#*#.#*#.
-./././.-
-//*#*//-
#./././.#
.#*#.#*#.
#.......#
#*.....*#
*.......*