.........
----.----
////.////
////.////
****.****
****.****
####.####
####.####