---------
----.----
///...///
//.....//
*.......*
**.....**
###...###
####.####

