---------
----#----
-#/.../#-
-#//*//#-
-.......-
-//*#*//-
-.......-
-/*#.#*/-