---------
---------
/////////
/////////
*********
*********
#########
#########